#######
#--#--#
#--#--#
#--#-b#
e-----#
#-----#
#######
